NO ./texture/north.xpm
SO ./texture/wall.xpm
WE ./texture/wall.xpm
EA ./texture/wall.xpm
F 0,100,0
C 25,25,112

111111111111
1G0000R000H1
100000000001
10000N000001
100000000001
111111111111
